111111110111
1C0000000001
1E0000000001
111111111111