1111111111
1P000001C1
1000000011
1000000111
1C00001E11
1111111111