111111111111
10000C00P0001
1E0000000001
111111111111