111111111111111111
1100001C0000000001
1P0000110000C10C01
100011100000011101
1110000000E0000001
1C000101C0000001C1
111111111111111111