1111111111111111111111
1E0000000C0000C0000001
1011100100101010010101
1010010101001010010101
1P0000C0000000000000C1
1111111111111111111111