1111111
1000E01
1CCCCC1
1000001
100P001
1111111