111111111111
10000C00P001
1E000000000C
111111111111