111111111111
C0000C00P001
1E0000000001
111111111111