11111111111111111111111111111111111111111
1P000000000000000000000000000000000000001
100000000001
100000000000000000000000000000001
10101010101010101010101010000C00001111111
100000000000000000000010111
10000000000000000000001011111111111111111
1000000000000000000000101
10000000000000000000001E111111
11111111111111111111111111111111111111111