1111111
1000E01
100C001
100C001
1000001
1111111