111111111111
10000C00P001
1E0000000001
111111011111