11111111111
1c000p000c1
11111e11111
11111111111




