11111
1EP11
1C001
10011
1C001
11111