111111111111111111111
1100000000C0000000001
1P1000000000000000001
1110000000CE000000001
111111111111111111111