11111111111111
1PC0C0C0C00E01
10000000000111
11111111111111