11111111111111
1PC0C0C0C00EC1
10000000000111
11111111111111