111111111111111111111
1100000000PC000000001
111000000000000000001
1111100000EC000000C01
1111110000C0000111111
1111111C0000011111111
111111100001111111111
111111111111111111111